       #          
#####  #### ######
                  
### #  #         #
#   #  ######### #
    #       #     
#   #  # #     ###
#   #  # ####### #
### # ## #  #  # #
    #  # #  #     
#   ## # #  #### #
#      # #       #
#  ##       #     
  # #  ###########
60
